53处术语习语的替换如下：
cx（点选）	点击
回螅回报）	反馈
送出	提交
送出请求	发出请求
作业系统	操作系统
Υ妫ù⒋)	保存
Y（资讯）	信息
搜ぃㄋ蜒埃	搜索
清危ㄇ宓ィ	列表
纯文字	纯文本
月眩ㄔ吕）	日历
寄件副本清(寄件副本清单)	邮件抄送列表
D形n（图形档）	图片文件
位址	地址
n案（档案）	文件
Dn	图片
支援	支持
窗	窗口
z	查看
U（废弃）	作废
BY（连结）	链接
管理者	管理员
使用者	用户
h端	远程
伺服器	服务器
出	发布
进行中	处理中
已认证	已通过
a品（产品）	项目/专案
子a品（子产品）	模块
滑鼠	鼠标
Y料集（资料集）	数据集
登入	登录
字元	字符
覆	覆盖
正表_式（正规表达式）	正则表达式
图示	图标
政策	策略
辨识	辨别
智Z（智语）	标语
留白	留空
半形逗号	半角逗号
重制	重现
此一	此
进阶	高级
新增账号	注册账号
主要电子邮件	常用电子邮件
较长的描述	详细描述
电脑组态	电脑配置
友善	方便
列印	打印
包覆	括住
背景	后台